{"size":20,"grid":[
  "30000000000000010000",
  "00000000000000000010",
  "00000010000000000000",
  "00000000000000000000",
  "20000001000000000000",
  "00000000000110000010",
  "01000000000000000110",
  "00010000000000101000",
  "01100010000000111100",
  "00000000120000000000",
  "00000000000000000000",
  "00000000000000000100",
  "00000000000000000000",
  "01000001000000001000",
  "00000100000000001110",
  "01000000100000000000",
  "11000010000000000000",
  "00000000002100000010",
  "01010000000010000000",
  "10001100000001000000"],"treasures":3}